####################******####################
#******************#******#*****************!#
#******************#******#******************#
#******************########******************#
#********************************************#
#********************************************#
#******************########******************#
#******************#******#******************#
#******************#******#******************#
#******************#******#******************#
#******************#******#******************#
#p*****************#******#******************#
####################******####################